1;1;0;206;0;0;0;0;0;0;0;0;0
2;2;0;206;0;-1;1;0;0;0;0;0;0
3;3;0;207;0;0;0;0;0;0;0;0;0
4;4;0;206;0;13;0;1007;1007;0;1005;1005;CHR
5;8;0;0;0;4;12;1017;1017;0;1018;1018;STR,2,CON,2,WILL,1,LUCK,1
6;8;0;0;0;4;12;1019;1019;0;1020;1020;INT,2,WILL,2,WILL,1,LUCK,1
7;6;0;0;0;0;0;0;0;0;0;0;0
8;7;0;0;0;0;0;0;0;0;0;0;0
9;9;0;0;0;2;0;0;0;0;0;0;STR,1,CON,1
10;9;0;0;0;2;0;0;0;0;0;0;INT,1,WILL,1
11;10;0;0;0;2;0;1021;1021;0;1022;1022;0
12;5;0;0;0;0;1;0;0;0;0;0;0
13;5;0;0;0;1;1;0;0;0;0;0;0
14;5;0;0;0;2;40;0;0;0;0;0;0
15;5;0;0;0;3;300;0;0;0;0;0;0
16;5;0;0;0;4;1000;0;0;0;0;0;0
17;11;0;206;0;0;0;0;0;0;0;0;0
18;13;0;0;0;1;0;0;0;0;0;0;0
19;14;0;0;0;1;0;0;0;0;0;0;0
20;15;0;0;0;0;0;0;0;0;0;0;0
