100;INTERACT_DOOR_FOREST_DUNGEON;1;2;1043;-1;-1;1;1;0;0;0;0;0;0;6000;-1;-1;6001;ANIMATION_INTERACTABLE_IDLE;-1
101;INTERACT_FISHING;3;10;1049;-1;-1;1;1;1;1;1;1;0;0;6002;-1;-1;-1;ANIMATION_INTERACTABLE_IDLE;-1
102;INTERACT_CHEST;13;1;-1;46;50;1;1;0;1;1;1;47;0;6003;6004;6008;6005;ANIMATION_INTERACTABLE_IDLE;1019,1022
103;INTERACT_MIMIC;12;1;-1;48;49;1;1;0;1;1;0;0;0;6006;2515;-1;6007;ANIMATION_INTERACTABLE_IDLE;-1
104;INTERACT_SIGN;5;7;1054;-1;-1;1;1;0;1;1;0;0;0;6009;-1;-1;-1;ANIMATION_INTERACTABLE_IDLE;-1
105;INTERACT_SIGN;11;0;1055;-1;-1;1;1;0;1;1;0;0;0;6011;-1;-1;-1;ANIMATION_INTERACTABLE_IDLE;-1
106;INTERACT_GATE;5;4;-1;-1;-1;1;1;0;0;1;0;0;0;6012;6018;-1;6013;ANIMATION_INTERACTABLE_IDLE;-1
107;INTERACT_SWITCH;6;5;-1;51;-1;1;1;0;1;1;0;52;0;6014;6015;6017;6016;ANIMATION_INTERACTABLE_IDLE;-1
108;INTERACT_TRAP;3;3;-1;54;-1;1;1;1;1;1;0;53;0;6019;-1;-1;6020;ANIMATION_INTERACTABLE_IDLE;-1
