map1_transit.txt
map1_enemies.txt
g^g^g^t^t^t^g^r>-v->g^g^r>
g^g^g^t^t^t^g^g^g^=>g^g^g^
g^g^g^w^w^w^g^u<g^u>g^g^g^
n^g^g^g^g^g^g^=>g^g^g^g^g^
-^u^g^g^uv=^=^r^g^g^g^g^rv
->g^g^o^g^g^g^g^g^uv-^-^c^
r^g^g^g^g^g^g^g^g^g^r>-v-v
g^g^uvu^g^g^g^g^g^g^g^g^g^
g^g^g^g^g^g^g^g^g^o^g^g^g^
r<g^rv-^r<g^g^g^g^g^g^g^g^
->g^r>c^c^-^-^-^-^-^u^g^rv
c^r<g^-<c^-vc^c^c^r^g^rvc^
c^->g^r>r^g^-<c^->g^uvc^c^
c^->g^g^g^g^r>c^c^u^g^-<c^
c^c^r<g^g^g^g^r>r^g^g^-<c^
c^c^c^-^-^r<g^g^g^g^rvc^c^