map1_transit.txt
map1_enemies.txt
g^g^g^t^t^t^g^r>-v->g^g^r>
g^g^g^t^t^t^g^g^g^=>g^g^g^
g^p^p^w^w^w^g^u<g^u>g^g^g^
n^g^p^g^g^g^g^=>g^g^g^g^g^
-^u^p^g^uv=^=^r^g^g^g^g^rv
->g^p^o^g^g^g^g^g^uv-^-^c^
r^p^p^g^g^s^s^s^g^g^r>-v-v
g^p^uvu^g^s^s^s^g^g^g^g^g^
g^p^p^p^p^x^d^x^g^o^g^g^g^
r<g^rvr<p^p^p^g^g^g^g^g^g^
->g^r>c^c^-^-^-^-^-^u^g^rv
c^r<g^-<c^-vc^c^c^r^g^rvc^
c^->g^r>r^g^-<c^->g^uvc^c^
c^->g^g^g^g^r>c^c^u^g^-<c^
c^c^r<g^g^g^g^r>r^g^g^-<c^
c^c^c^-^-^r<g^g^g^g^rvc^c^