map4_transit.txt
4
7509,0;7508,0;7508,0;7508,0;7508,0;7508,0;7508,0;7509,0;
7509,0;7513,0;7513,0;7513,0;7513,0;7513,0;7513,0;7509,0;
7509,0;7513,0;7513,0;7513,0;7513,0;7513,0;7513,0;7509,0;
7509,0;7513,0;7513,0;7513,0;7513,0;7513,0;7513,0;7509,0;
7508,0;7508,0;7508,0;7508,0;7513,0;7508,0;7508,0;7508,0;